11111111111111111111111111111111111111111111111111
11111111111111111111111111111111111111111111111111
11111111111111111111111111111111111111111111111111
11111111111111111111111111111111111111111111111111
11111111111111111111111111111111111111111111111111
11111111111111111111111111111111111111111111111111
35555541113555555555555555541135555555555555555554
22222221112222222222222222221122222222222222222222
22222221112222222222222222221122222222222222222222
22222221112222222222222222221122222222222222222222